 -1  -1  -1  -1  -1  -1  -1  -1  -1  -1  -1  -1  -1  -1  -1  -1  -1  -1  -1  -1   0   1   2  -1  -1  -1  -1  -1  -1  -1  -1  -1  -1  -1  -1  -1  -1  -1  -1  -1   0 
  0   0   0   0   0   0   0  -1   0   0   0   0   0   0   0   0   0   0   0   0   0   0   3   4   5   6   7  -1   0   0  15  16  17  18  19  -1   0   0   0  -1   0 
  0   0   0  -1  -1  -1  -1  -1   0   0   0  -1  -1  -1  -1  -1   0   0   0  -1  -1  -1  -1  -1   0   0   8  -1   0   0  14  -1   0   0  20  -1   0   0   0  -1   0 
  0   0   0   0   0   0   0   0   0   0   0   0   0   0   0  -1   0   0   0   0   0   0   0  -1   0   0   9  10  11  12  13  -1   0   0  21  -1   0   0   0  -1   0 
  0   0   0  -1  -1  -1  -1  -1  -1  -1  -1  -1  -1  -1  -1  -1  -1  -1  -1  -1   0   0   0  -1  -1  -1  -1  -1  -1  -1  -1  -1   0   0  22  -1   0   0   0  -1   0 
  0   0   0   0   0   0   0  -1   0   0   0   0   0   0   0   0   0   0   0   0   0   0   0  -1   0   0   0   0   0   0   0  -1   0   0  23  -1   0   0   0  -1   0 
 -1  -1  -1  -1  -1  -1  -1  -1   0   0   0  -1  -1  -1  -1  -1  -1  -1  -1  -1  -1  -1  -1  -1  -1  -1  -1  -1   0   0   0  -1   0   0  24  -1   0   0   0  -1   0 
  0   0   0   0   0   0   0  -1   0   0   0  -1   0   0   0   0   0   0   0  -1   0   0   0   0   0   0   0   0   0   0   0  -1   0   0  25  26  27   0   0  -1   0 
  0   0   0  -1   0   0   0  -1   0   0   0  -1   0   0   0  -1   0   0   0  -1   0   0   0  -1  -1  -1  -1  -1   0   0   0  -1  -1  -1  -1  -1  28   0   0  -1   0 
  0   0   0  -1   0   0   0   0   0   0   0  -1   0   0   0  -1   0   0   0   0   0   0   0  -1   0   0   0   0   0   0   0  -1  33  32  31  30  29   0   0  -1   0 
  0   0   0  -1  -1  -1  -1  -1  -1  -1  -1  -1   0   0   0  -1  -1  -1  -1  -1  -1  -1  -1  -1   0   0   0  -1  -1  -1  -1  -1  34   0   0  -1  -1  -1  -1  -1   0 
  0   0   0   0   0   0   0   0   0   0   0   0   0   0   0  -1   0   0   0   0   0   0   0   0   0   0   0  -1   0   0   0  -1  35   0   0  -1   0   0   0  -1   0 
 -1  -1  -1  -1  -1  -1  -1  -1   0   0   0  -1  -1  -1  -1  -1   0   0   0  -1  -1  -1  -1  -1  -1  -1  -1  -1   0   0   0  -1  36   0   0  -1   0   0   0  -1   0 
  0   0   0   0   0   0   0   0   0   0   0  -1   0   0   0   0   0   0   0  -1   0   0  47  46  45  44  43  42  41  40  39  38  37   0   0  -1   0   0   0  -1   0 
 -1  -1  -1  -1   0   0   0  -1  -1  -1  -1  -1  -1  -1  -1  -1  -1  -1  -1  -1   0   0  48  -1  -1  -1  -1  -1  -1  -1  -1  -1  -1  -1  -1  -1   0   0   0  -1   0 
  0   0   0  -1   0   0   0   0   0   0   0   0   0   0   0   0   0   0   0  -1   0   0  49  -1   0   0  57  58  59  60  61   0   0   0   0   0   0   0   0  -1   0 
  0   0   0  -1  -1  -1  -1  -1  -1  -1  -1  -1  -1  -1  -1  -1   0   0   0  -1   0   0  50  -1   0   0  56  -1   0   0  62  -1  -1  -1  -1  -1  -1  -1  -1  -1   0 
  0   0   0  -1   0   0   0   0   0   0   0   0   0   0   0   0   0   0   0  -1   0   0  51  52  53  54  55  -1   0   0  63  64  65  66  67  68  69   0   0  -1   0 
  0   0   0  -1   0   0   0  -1  -1  -1  -1  -1  -1  -1  -1  -1  -1  -1  -1  -1  -1  -1  -1  -1  -1  -1  -1  -1  -1  -1  -1  -1  -1  -1  -1  -1  70   0   0  -1   0 
  0   0   0   0   0   0   0  -1   0   0   0   0   0   0   0   0   0   0   0   0   0   0   0   0   0   0   0   0   0  78  77  76  75  74  73  72  71   0   0  -1   0 
 -1  -1  -1  -1  -1  -1  -1  -1  -1  -1  -1  -1  -1  -1  -1  -1  -1  -1  -1  -1  -1  -1  -1  -1  -1  -1  -1  -1   0  79   0  -1  -1  -1  -1  -1  -1  -1  -1  -1   0 
